111111111111111111111111111111111111
1P000E00000010000000000010000000C001
101111111011010111101110101111011111
100000001010010100000010101000010011
101111101010111010111110101011111011
100000001000001010100000000000000011
111110111011101010111011111111101111
1C0000000000100000000000100000000001
111111111111111111111111111111111111
