111111111111111
10000C000011111
100000C00111111
1000P0000110111
10C000000111111
1000C0000111111
100000000111111
111111111111111