1111111
1P100E1
1111101
1C00M01
1111111
