1111111
1P000E1
1011101
1C00M01
1111111
